"date","confirmed_new","confirmed_total","deaths_new","deaths_total","recovered_new","recovered_total","active_new","active_total","tested_new","tested_total","hospitalised","hospitalised_intensive"
2020-02-25,0,0,0,0,0,0,0,0,NA,NA,NA,NA
2020-02-26,0,0,0,0,0,0,0,0,NA,NA,NA,NA
2020-02-27,0,0,0,0,0,0,0,0,NA,70,NA,NA
2020-02-28,1,1,0,0,0,0,1,1,46,116,NA,NA
2020-02-29,0,1,0,0,0,0,0,1,26,142,NA,NA
2020-03-01,0,1,0,0,0,0,0,1,23,165,NA,NA
2020-03-02,0,1,0,0,0,0,0,1,26,191,NA,NA
2020-03-03,0,1,0,0,0,0,0,1,24,215,NA,NA
2020-03-04,0,1,0,0,0,0,0,1,16,231,NA,NA
2020-03-05,0,1,0,0,0,0,0,1,8,239,NA,NA
2020-03-06,0,1,0,0,0,0,0,1,8,247,NA,NA
2020-03-07,0,1,0,0,0,0,0,1,7,254,NA,NA
2020-03-08,0,1,0,0,0,0,0,1,6,260,NA,NA
2020-03-09,0,1,0,0,0,0,0,1,15,275,NA,NA
2020-03-10,2,3,0,0,0,0,2,3,15,290,NA,NA
2020-03-11,0,3,0,0,0,0,0,3,31,321,NA,NA
2020-03-12,0,3,0,0,0,0,0,3,45,366,NA,NA
2020-03-13,3,6,0,0,0,0,3,6,76,442,NA,NA
2020-03-14,1,7,0,0,1,1,0,6,78,520,NA,NA
2020-03-15,5,12,0,0,0,1,5,11,104,624,NA,NA
2020-03-16,6,18,0,0,0,1,6,17,118,742,NA,NA
2020-03-17,8,26,0,0,0,1,8,25,193,935,NA,NA
2020-03-18,8,34,0,0,0,1,8,33,92,1027,NA,NA
2020-03-19,14,48,0,0,0,1,14,47,127,1154,NA,NA
2020-03-20,21,69,1,1,0,1,20,67,233,1466,NA,NA
2020-03-21,30,99,0,1,0,1,30,97,384,2086,NA,NA
2020-03-22,44,143,0,1,0,1,44,141,278,2361,NA,NA
2020-03-23,36,179,0,1,0,1,36,177,373,2734,NA,NA
2020-03-24,30,209,1,2,0,1,29,206,737,3471,NA,NA
2020-03-25,65,274,2,4,0,1,63,269,849,4320,NA,NA
2020-03-26,71,345,0,4,0,1,71,340,1175,5495,NA,NA
2020-03-27,37,382,1,5,0,1,36,376,1405,6900,NA,NA
2020-03-28,55,437,2,7,0,1,53,429,1524,8424,NA,NA
2020-03-29,47,484,0,7,0,1,47,476,1467,9891,NA,NA
2020-03-30,49,533,0,7,6,7,43,519,1389,11280,NA,NA
2020-03-31,48,581,1,8,0,7,47,566,1294,12574,NA,NA
2020-04-01,68,649,1,9,0,7,67,633,2444,15635,NA,NA
2020-04-02,47,696,0,9,0,7,47,680,2809,18432,NA,NA
2020-04-03,76,772,1,10,0,7,75,755,2944,21376,NA,NA
2020-04-04,39,811,3,13,0,7,36,791,2269,23645,NA,NA
2020-04-05,32,843,2,15,1,8,29,820,1954,25599,NA,NA
2020-04-06,37,880,0,15,0,8,37,857,2208,27807,NA,NA
2020-04-07,32,912,0,15,0,8,32,889,2301,30108,NA,NA
2020-04-08,42,954,0,15,0,8,42,931,2699,32809,NA,NA
2020-04-09,45,999,1,16,0,8,44,975,3242,36051,NA,NA
2020-04-10,27,1026,6,22,46,54,-25,950,2421,38472,NA,NA
2020-04-11,27,1053,2,24,47,101,-22,928,2240,40712,NA,NA
2020-04-12,9,1062,0,24,0,101,9,937,791,41503,NA,NA
2020-04-13,8,1070,0,24,0,101,8,945,1187,42690,NA,NA
